1IX1110111
1011011001
0011110110
1010111010
1001010101
0001101010
0010001111
1010101011
1000100010
0100100010
